+-+-+-+-+-+-+-+-+-+-+-+-+-+-+-+-+-+-+-+-+-+-+-+-+-+-+-+-+-+-+-+-+-+-+-+
S   |     |   |   |     |       |   |       |                   |     |
+ + +-+-+ + + +-+ + +-+ + + +-+ + +-+ +-+-+ +-+-+-+-+-+-+-+-+-+ + +-+ +
| |   |   | |     | |   | |   | | |   |   |           |     |   | | | |
+-+-+ + + + +-+-+-+ + +-+-+-+ +-+ + +-+ + +-+-+-+ +-+ + +-+ + +-+ + + +
|       |   |   |   |       |   | | |   |         |   |   | | |   |   |
+ +-+-+-+-+-+-+ + +-+-+-+-+ +-+ + + + +-+-+-+-+-+-+ +-+-+ +-+ + +-+-+-+
|       |     | |   |     |       | |         |   |     |   | |       |
+ +-+-+ + +-+ + +-+-+ +-+ +-+-+ +-+ +-+-+-+-+ +-+ +-+-+-+-+ + +-+-+ + +
|     | | |   |   |   |       | |   |   |   |   |     |     | |   | | |
+ +-+ +-+ + +-+ +-+ +-+ + +-+ + +-+ + +-+ + +-+ +-+-+ + +-+-+ +-+ +-+ +
|   | |   | |       | | | | | |     |     |     |     | |     |   |   |
+-+-+ + +-+ +-+-+-+-+ + + + + + +-+-+ +-+-+-+-+-+ +-+-+ + +-+-+ +-+ + +
|   |   |   |   |     | | |   | |   |   |       | |   | |     |     | |
+ + +-+-+ +-+ + + +-+-+ + +-+ + +-+ +-+-+ + +-+ + + + + +-+-+ +-+-+-+ +
| |   | | |   | |       | |   | |         | |   |   | |     | |       |
+ +-+ + + +-+-+ +-+-+-+-+ + +-+ + +-+-+-+-+ +-+-+ +-+-+-+-+ + +-+ +-+ +
|   | | | |   | |   |   | |     |   | |   |       | |   |   |   |   | |
+-+ + + + + + + + + + + + +-+-+-+-+ + + + +-+ +-+-+ + + + +-+-+ + +-+ +
| | |   |   | |   |   |   |       | |   |   | |   |   | |     |   |   |
+ + +-+-+-+ + + +-+-+-+-+-+ +-+-+ + +-+-+-+ +-+ + + +-+ +-+-+ +-+-+ +-+
| |       | |   |   |     | |   |     |     |   | | |       |         |
+ +-+ +-+ + +-+-+ + + + + +-+ + +-+ + + +-+-+ +-+ + +-+-+-+ +-+ +-+-+ +
|   |   |   |     | | | |   | | |   |   |       | |   |   |   | |     |
+-+ +-+ +-+-+ +-+-+ + + +-+ +-+ +-+ +-+-+ +-+ + + +-+ + +-+-+ + + +-+-+
|       |   |   |   | | |   |   |   |     | | | | |   |       | | |   |
+ +-+-+-+ +-+-+ + +-+ + + +-+ +-+ +-+-+-+-+ + + + + + +-+-+-+-+-+ + + +
| |     |       | |   | |     | |       |   | | | | | | |           | |
+ +-+-+ +-+-+-+ + + +-+ +-+-+ + +-+-+-+ + +-+ + + +-+ + + +-+-+-+-+-+ +
|     | |   |   |   |   |   |   |   | |     | | | |   |   |           |
+-+-+ + +-+ + +-+-+ + +-+ + +-+-+ + + +-+-+ +-+ +-+ +-+ + + +-+-+-+-+-+
|     |   | | | |   |     | |     | |   |     |         | | |         |
+ +-+-+-+ + + + + +-+-+-+-+ + +-+-+-+ + +-+ + + +-+ +-+-+ + + +-+-+-+ +
| |         | | |       |   |         |   | |   |   |   | |   |     | |
+ + +-+ +-+-+ + +-+-+-+ + +-+-+-+-+-+ +-+ +-+ +-+ +-+ + +-+-+-+ +-+-+ +
| | |   | |   |         |   |       |   |     |   |   |     | |       |
+ + + +-+ + +-+-+-+-+-+-+-+ + + +-+-+-+ +-+-+-+ +-+-+ +-+-+ + +-+-+ + +
|   |   | | |           |   | |     | | |   | |       |     | |   | | |
+-+-+-+ + + + + +-+-+ +-+ +-+ +-+-+ + + + + + +-+-+-+-+ +-+-+ + + + + +
|   | |   | | | | |     | |   |   |     | | |   | |     |     | |   | |
+ + + +-+ + + + + + +-+ + + +-+-+ +-+-+-+ + +-+ + + +-+ + +-+-+ +-+-+-+
| |     |   | |   |   |   | |     |       |     |     | | | |   |     |
+ +-+-+-+-+-+ +-+-+-+ +-+-+ + +-+-+-+ +-+-+-+-+-+-+-+ +-+ + + +-+-+-+ +
|             |     |       |   | |               |   |   |   |       |
+-+ +-+-+-+-+-+ + + +-+-+-+-+-+ + + +-+-+-+-+-+-+ + +-+ +-+-+-+-+ + +-+
|       |   | | | | |             |       |   | |   |   |   |   | | | |
+-+-+ +-+ + + + +-+ + +-+-+-+-+ + +-+-+-+ + + + +-+-+ +-+ + +-+ + + + +
|   | |   | |   |   | |       | | |       | | | |       | | |   | |   |
+ + + + +-+ + +-+ +-+ + +-+-+ + + + + +-+-+ + + + +-+-+-+ + + +-+ +-+-+
| | |   | | |   |     |     | | |   | |     | | |     |   |   |   |   |
+ + + +-+ + +-+ +-+-+-+-+-+ + + +-+-+ + +-+-+ + +-+-+ + + +-+-+ +-+ + +
| | | | | | | |     |     | | | |   |   |     |       | |     |     | |
+-+ + + + + + + +-+ + +-+ +-+ + + + + +-+ +-+-+ +-+-+-+ +-+ +-+-+-+ + +
|   |   |     | |   | | |   | | | | | | |       |   |   |   |   |   | |
+ +-+ +-+-+-+-+-+ + + + +-+ + +-+ + + + +-+-+-+-+ + + +-+-+-+ + + +-+ +
| | | |       |   | | |     | |   |   |     |   | | | |       |     | |
+ + + + +-+-+ + +-+-+ + +-+ + + +-+-+-+-+-+ + + + + + + +-+-+-+-+-+ + +
| |   |   |   |       | |   |   |         | | |   |   | |   |   |   | |
+ +-+-+-+ + +-+-+ +-+-+ +-+-+-+-+ + +-+-+ + + +-+-+-+-+ + + + + + +-+ +
| |     | |       |     |   |     |     |   |       |   | | | |   |   |
+ +-+-+ + +-+-+ +-+ +-+-+ + + +-+ +-+-+ +-+-+-+-+-+ +-+-+ + + +-+-+ +-+
|       | |   | |   | |   | |   | |   |     |     | |     |   |   |   |
+-+-+-+ + +-+ +-+ +-+ + +-+ +-+ + +-+ +-+ + + +-+-+ + +-+-+-+-+ + +-+ +
| |   | |       |     | |   |   |     |   |     |   |   |   |   |   | |
+ + + + +-+-+-+ +-+ +-+ + +-+-+-+ +-+-+ +-+-+-+ + +-+-+ + + + +-+ +-+ +
|   | |       | |   |   |         |     |       |       | |   |   |   |
+-+-+ +-+ +-+ + +-+-+ +-+-+-+-+-+-+ +-+-+ +-+-+-+-+ +-+-+-+-+-+ +-+ +-+
|   |     |   |     | |       |   | |     | |   |     |     | |   |   |
+ + +-+-+-+-+ +-+-+ + +-+-+-+ +-+ + + +-+-+ + + +-+-+ + +-+ + +-+ +-+ +
| |         | |   | |       |       |     |   |   |   | |   | |   | | |
+ +-+-+-+-+ + + + + +-+ +-+ +-+-+-+-+ +-+ + +-+-+ + +-+ + +-+ + +-+ + +
|     |         |     |   | |     |   |   | |       |   | |     |     |
+-+-+ +-+-+-+ +-+-+-+-+-+-+ +-+-+ +-+-+ +-+-+ +-+-+-+ +-+ + +-+-+ + +-+
|     |   |   |       |   |     |     | |   |   |   |   | | |     |   |
+ +-+-+ + +-+-+-+-+-+ + + +-+ + +-+-+ + + + +-+ +-+ +-+ + + +-+-+-+-+ +
|       |   |     |   | |   | | |   |   | |     |   |   |   |     |   |
+-+-+-+-+-+ + +-+ +-+ + +-+ + + + + +-+-+ +-+-+ + +-+ +-+-+-+ +-+ + +-+
|         | | | |     |   | | | | | |     |           |     |   |   | |
+ +-+-+-+-+ + + +-+-+ +-+ + + + + + + +-+-+-+-+-+-+ +-+ +-+ +-+ +-+-+ +
|     |   |   | |   |     | | |   | | |           |   | |   |   |     |
+-+ +-+ + +-+ + +-+ +-+ + + + +-+-+ + + +-+-+-+-+ + + +-+ +-+ +-+-+-+ +
| |     | |   |       | | |   |   |   | |         | |     |     |     |
+ +-+-+-+ +-+-+-+-+ + + + +-+-+ + + +-+ + +-+-+-+-+ +-+-+-+-+-+ + +-+-+
|       |   |       |   |   |   | |     |   | |   | |           | |   |
+-+-+-+ +-+ + +-+-+-+-+-+-+ + +-+-+-+-+-+-+ + + + +-+ + +-+-+-+-+ + + +
|     |     |       |       | |           | |   |   | | |   |       | |
+-+-+ +-+ +-+-+-+-+-+ +-+-+-+ + +-+-+-+-+ + +-+ +-+ +-+ + + + +-+ +-+ +
|   | |   | |   |     |     |   |     | |   | |   |     | | | |   | | |
+ + + + +-+ + + + +-+-+ +-+-+ +-+ +-+ + +-+-+ +-+ +-+-+-+ + + + + + + +
| |   |       |       |     | |   |         | |   |       |   | | | | |
+ +-+-+-+-+-+-+-+ +-+-+-+-+ + + +-+-+-+ +-+ + + +-+ +-+-+-+-+-+-+ + + +
| |               |       | | |     | |   |   | |   | |   |       |   |
+ + +-+-+ +-+-+-+-+ +-+ + + +-+-+-+ + + + +-+-+ + + + + + + +-+-+ +-+-+
|   |   |     |     |   |   |     |   | |     |   | | | | | |     |   |
+ +-+ + +-+-+ + +-+-+ +-+-+-+ +-+ +-+-+-+-+-+ + +-+-+ + + + + +-+-+-+ +
|   | |   | |   |   |         |   |           |       | | | | |       |
+-+ +-+-+ + +-+ + +-+-+-+-+-+-+-+ + +-+-+-+ +-+-+ +-+-+ +-+ + + +-+-+-+
|   |   | |     | |       |       | |   | |   | |     |     | | |     |
+ +-+ + + +-+-+-+ + + + +-+ +-+-+ + + + + +-+ + +-+-+-+-+-+-+ + + +-+ +
|     |   |         | |     |     |   |   |                       |   F
+-+-+-+-+-+-+-+-+-+-+-+-+-+-+-+-+-+-+-+-+-+-+-+-+-+-+-+-+-+-+-+-+-+-+-+